(0, 0)
(7, 111)
(150, 81)
(22, 3)
(56, 33)
(126, 101)
(69, 77)
(25, 35)
(30, 68)
(38, 21)
111111112111212221121022012201201021111011110111111101101a1101111110011110001a11110011001111111111001111111001111010111111001111111a1111111111111111111110110111
011111121121112021012212022222222222011111111111110111011a1110111110011111011a11111011110011100111111111111111101111111111101111100a1111101011110011111110111101
111111122120121222210212011100211121010101111011101010111a1011011110111101101a11110111111111011101111111001111111101101111110001111a1111001111111111111001111111
111011121121112021110201222112111210010001010011111111101a0111101110111111111a11111011011111110010110111111011011110101111011010011a1111101011011111101110100110
111110111012201211211111112221112022211111110110011111101a1111111111010111111a11110111101111111111101111010101011101111110011111111a1111111100110111111001100101
111011101102210221220021111222112101011110011111111111011a0110111111110111111a01111111111011001010110111101011111111111011110011101a1111110111100111011111111111
010111101112212122101101122201222002112211012102110120111a1100111011111111111a11111111111111110111111111111111100011111110100111111a1000110110111111001111111101
110110012212111122111120022222022122202202211121021111111a0111101011111111111a11101011110111111110111110101111011111111111110111011a0101101111110110111111110111
111101120210122212211110222222220220010002122122212121011a1011101111001001111a10111101111001011111111111111110101111001111011101011a1011111111111011110111110110
001111111111021111212212222022002022210221222211122221111a0110111101111111101a01110111111011111111111101111001111111111111100111000a1011101110100111111110111000
111000021022002121201111221221220220202122211111121101101a1101011111101011111a11111001111111101110111111111101011011011111110111111a1111110111111011110111111111
111111110011101202212002020200001222020202212210212021011a1111100101111111010a01101111111110111111110111101100111111011010111111011a1111111110010011101111111111
001101102112021202022210222222120012100020102221222111101a1111011111010111011a11111111111111111011101001011111110101111100111110111a1111111111010111111111011101
110110111211111121112012022222220212022111111200020020010a0110100111111111111a11111101011110101110010101111111111011111111010110111a1111111101111111111111011101
111110122221122112112212221220022022000001200110212210111a1110111100101111101a01100011111111111001110010111101111110010101111111011a1111101011111001101110011011
111101122121222022011112002222201211111021020122112011011a1111111111100100111a00111110111111111111111101111111111111111101111011100a0101101111111111101111111010
111011121022222021122222221102121212121112112111021210110a1110011111111111111a11111101111101111111011111101110110111111111011110110a1111111111011111001110011111
111111011202122221002121122201021022102202111222020210111a1111111111111111111a11111111111111110011111110111111110111111111110001111a1111011111011111101110100111
011111110011001110111102122111220211122112222111101220221b2011002122212101000a11111111011101100110101111111101101111111111110111111a0101110011111111100111010111
101111100110101001111110222222121021020212212222200212102a0200212121111011101a10111111111101101011110101000011111111111110111011111a1111111111111110111111011111
111011101121100001122222012221020220222212211222222212222a0210112212122011111a11101100001110001011111110111011101111111101101111111a1110111111111111101111101111
001011011011121112020112022202010222200212200222120221021b0101111021120000111a11111011111111111111011111101111111111111111110110111a0111010110101101111101011000
111011111122212211111210121221222112212210020212200211120b1202110210220110110a11011110111111101111111010010111111111111011110111111a0101110111111111011111111111
010110101012022111222210220221212220202212122222011201022b2221211111212111011a11011111111011111110111111111111011111110111111101111a1111011111101111110111001101
111111110102022211102002212212222220022201022220002221011b2221001210222110111a00011111111010101111010111111111110101111011111100111a0101110110111111101111111101
111110010002201110121112222221112222121210222222222001122a1021222120202011011a11110111111110111111111011111111110110011111111110111a0111111010111111110111110111
011111011102012202122002121012202221022122122120002121022b2222102121201101011a11111110111101110111110110111111111001111011110001111a0010110011110111111111110110
111111111001110101122111221122022201221022020222122210112b2001001112010111111a11111111011111011011111110111111111111010110111110111a1111101010111100111111111111
011111100120020112202111221002210122222222200011211212122b1202201121222111101a10111111111110101011101111001110011111111111110111111a1101100111111101110011111111
111110111101102220112202120121102222222102222122220202222b1201012111121111111a11110111110101011101111101001100110001110000001111111a1111111011110011101011111110
111011011121021122222222210220122222002012222222221200022a1101202211111010111a11101110101111111111011111111110110111111111111111111a1111011111001111011110111111
111111111122222121112012212222212201210012222112210212121a1200022112211111100a01111011011111111011110110011011111011111111101101101a0111110110001001101111011100
111011111000101022121210112112021200212022222222200021000b1222001102121100101a01110011101011111111100111111111111111110111101110111a0111101111111111111010111011
111101100100210120112202202221222220022201001220112221211a2102201112211011111a10101011011111111111100101010111111111010101011010101a1111110101111111111111111101
111010111021111120022112022222012221202212020122122201022a0111202101220111110a11001111111001011111101101111111001111011101110110010a1111110111011010111111011110
111111011120021022121212221121222222021210221010120220222a2210112201200011110a11111101111110111111011011111111101110111010000111011a1011111011011111111101101111
101111011101110202221100112111102211201111222222221102122a2220012011112111111a01111111110110001111100011011110100010111010111011011a1111111111011110110011111110
111011111112012011101201000222222210002111120102000221111a1111102101221111011a11101110101111111111011101011111111110001101101011111a1011111101111111010101110111
101111110112211011012122202202211011111112021111101212122b1211221021122110111a01011110111111011010110111111111011011011111111111010a1001111110010111110111101110
110111111121201101211100102102122000210211111220102211111a0022220210212111000a11111110111011011100111111101110111111001111111100101a1111001011111111011110111111
110110010122001202122221120222101212222210110202212010021bbbaaaaaaabaaaaaaaaaa01010110011001011111111111111100111011010111110110111a1111111111111111111011110111
11110111102122011111112200112101221101210202211211012211202201202222210101111111011111111111111111111011110111011110101111010011101a0111110011111111111110111111
11001100012102110111122202101011121111211010112221211211220121201012112101111111111011110111111111111101111111101011110010111100111a1111100101111101111101111101
11111111111210011012211022022222211221110212101122221102022212001122010111111001111011111111111111101101111011111111101101101101011a1111111111111111101110011001
01001111112112201222112221022221221101011121122012202201221121210200021111110011101110111110001011111111011110111111101110011111101a0011111111111010111111111111
10111101011111111221111111220122102120001211022202111020110022211222022111111101111111101111111111111111111111001111110011111111111a1111011101111011111110111100
11011011111120220021222221212221120221211200221212221201121211010210222111111100110111101111010111111101010111111011111110101101111a1101111001001101111111111110
11111001110221001012221212110010211120121222101112112121112111122121121111010110011111011111111101110110111111011111111011101111111a1110011010011110111111001111
11111110012220011012222012222122022101201100111111111111101000110111011101110110111101110101111111111111011111111111111110011100110a1110111101111110111101101111
01000001102121010100220211020211211120101010111111101111111101101111011111101011111011111111111010110101001011111111111111111101111a1001111111101101111111111101
11110111111101111010111111101110101110111111111010101111111011110110110010011111110110011111101110011111101001000010111011110111011a0111101111111101101101101011
11011111111111111101110101111111010111111101011111010111010011111101111111101111111001000101111111111000110101111111011111110111010a0011101100111101110101110101
11111111111110001110011100111111111011111001110111001101110111111101111111111111001001010110011011111101111111111111110101111011011a0111110110111110111111010100
11111110111111010021222021022010210210112122111110111110111101111001001111101101101111111111101111111111100110111111111111111010111a0101111111111111111101100111
11011111111110122121122110221101111012222212011111111111011111111111111111101101011101111110011011001011101111001111010011111111101a1111111111111101111111110111
10001111001000120211121220001112022221122212011111001101111011001100111001101010111111001101111100111101111111111111011111111111111a1111101100111110011111011111
01101011111111020020111222112021212122202220100100111110111101111101101110011110111011111111101111011101111011100111111111110010111a1100101110011111000110101010
11111111110111122121201111122111201210212112211111100111111101111111111111110011111001010111111111111100111011100101110111111110011a1011111111111101011111111111
11001011011111112211111120022122102220200211111011111111110111011011111111111110101111111111111101111111011111111101110011011011110a1011101111101101010111101110
00111111111101122212022202122021022111211121011101101111111111111111111110101111101111111111111111101110010111111111111011100011101a1110101111111110001111101101
11011111101011102210111202122112100102200210101011110111111111110011111011111111011011111111011111111011110111111110011110111111100a1111111011111011111100100110
11011011111011120211001111100021122112011222011111111111111111011111111111111110011101111011101111110111111110110111101111111111111a1111111110111101111101111111
11110011111111121210100210212102111122202121111011111102220111122121122121021211100111111011111110001111101100111111111111111110111a0110111110111010111111111100
01011111010110111011022222220211211111022220211110011121102110012212220022111212221101111101011111011011001111111111111101101111111a0111111111110000011111111111
11101111110011100201202021210120001201212021111001111022011220220200120020221201112010111011111111010111111110001111111111101101011a1111011111111111110111111011
01100110111101121101122202110202202201101022110101111021211111021210222121201211102111001111111111011110011111111011101111111110110a0111111011111110111011111111
11111111111111122020111001020220222112212222211100111002110111111202201211221111022201101111011110011010110010011011111010111011100a1112122220022101001220222002
11111111110011120022122002021210021022111012210011111110122202122021122022110222001111010111111110111110111111111101000111111101110a0110212212000122020221211021
11111111101011001110011212221210220022112211211111110101002211221112212112220220022111111111111111011111110101111111111111101110111a1110222011021111121210022022
11110111011100122212202121111100102102002110011011011112211221202111022111122212110201011111111111111111111111111111100100101110111a0112202121000100221111111111
11001111111110121212121022122122211212122212211111111110221211201120022022121022122211010010110100101011111111110111011011111111111a0012102112002120210212212120
00101101100111112102121221110001001101122212211111110121010110211102102001212210121011011100111110101111001111111111101111111111110a1112212101210222002212112210
11110111011111011112220121202222122112220222211110101121221212121012220121121111120011111111110111111011100111111111111111110101011a1112211212120121222221010210
11011111111111111221122011010112222021111022011111111120100221110212012111010212220211110101111011101101111101101111101111011111111a0111122022011122021021101222
01011111101101011121021201121121101022221221011110101111121101112020021101211200021211010111111111111111111111011011001111001110101a1112101110120121102200221011
11011111111111010220222220122111102221121022110101011122120111020201122210122110002001101011111111111111111111111111101111111111011a1101220222222100111121020122
11100111110010001112002212111211202022212100110011111012210122121122212122210122111111111111111100011101111110101111111011111111111a1100022120001201221100211221
11011101010111121220110122122122202112222122110111111010100010202121110212212022021210111111111110011111111111111111010011010100111a1100112102112221201120110222
10011011111110021222222201011112112110111110011111001021212211220001001101111122011111111101110111011111111111110010101011101111110a1111212122102212002212102211
10101011111111112011120220212120011121121022111111001101212121011011202112211121002111100111111111111111111101110110100111110111110a1101120221011222222110020020
aaaaaaaaaaaaaaabbbbbbbabbbabaaababbabbaabbabaaaaaaaaaaabbbbabbbabaaaabbbaaaaaaabbbaaaaaaaaaaaaaaaaaaaaaaaaaaaaaaaaaaaaaaaaaaaaaaaaaa1110121211022112222211221222
1101111111111111120122111221222012110022211221111001002121011111022011120221221121111110111111001110111110110101111111110011111011010111222121221020200121120201
1111111111111002211102200212002011221211211021101111100102111011222221202121122212201110111111011110011011011111100011111110011001111111102111122111120120021211
1111111111101111110001111111111010101111101101101011011110110001000120111102022112021011111101111111111110011101111011101111111010111102211000002211222012101122
aaaaaaaaaaaaaaaaaaaaaaaaaaaaaaaaaaaaaaaaaaaaaaaaaaaaaababaaabbbbbbbbbababaababaabbbbaaaaaaaaaaaaaaaaaaaaaaaaaaaaaaaaaaaaaaaaaaaaaaaaaaabababaababbbbbaaabbbabbaa
1111111110111111101111111101111001110111111111001101111011112111222212122200211212221111111110111101111101011111110111011111111111010012222201121111021101022101
1011111111101101011111111110111111011111010111100111112212101021121221022112221122121101111111001110110111111001120201201202111112110202020201221212212121222211
1101111111111111011101111111111111110110101001111111110121222012102212012212211221121101111011101101111011101101112121102222122210100222212021210221012212200120
1110101110110111111111111110111011011111011110111111102101112222220022121211211012021111111011111011111111110011102121021101112210120021222222120201120122221101
0111011111101001111111110110111001110011111111111000110220221220221221211221222220001110111110111100011101111011111121111222121211200101222222111220222111221110
1011111011111111111111111111111011011011101110001011112110220112102110221101220212011111111111111111111101001101201012202021011222220111112122112212122120221211
1011011111111111111111110001110111111111011111111111111020101112221022112001202121210011111111111111101111111112200222220111110212222021122211210112200212222011
0000111111111111111001001001101010110111111111001111111110110001111011000111111110011111110101111111111011101112112221211121202212222122222122021122122101202210
1111111101111111111111110111101111111111111111111011100111111111101111111011111111110111111110110101111111011111121101022121110211012021220222212221101112122121
1011110111111111111111111101111100010111111111111101100011001111011111111111101011010011000101111111111100110112111220202122121212102102222120111110120200222221
1111111111111110001111010110111111001111111111110111010011111111101110011010101111011101010010111110111101111112112101121110120200112022201212101110012020122101
1110111111111101111111111111111111001011101110111111011111111100011101101111111111001011111011101010011111111112021121101022201111022211212211111011111111111110
1001111111101101110110111110111011110111001111111111111111111111111110110111001111110101111101111101110111011102111122110221111120012112000210011111110111111011
1101111110011111111001111011111110111101011111110111101111011110111110111111011011101101011111001111011111111112220110111211101110212011102211111011111111111111
1010101111111001101111aaaaaaaaaaaaaaaaaaaaaaaaaaaaaaaaaaaaaaaaaaaaaaaaaaaaaaaaaaaaa11111101101101111111100111110020220202010210022120122201210110111111111011111
1111100111111101011111a11101100111011011010101000111100111011111111111011101111011a11100001100111101111011111012211120012121221021001111120121111011111110110110
0111111111011111011110a01011001110111111011011111111011111101010111010111100100111a01100110111111101111111110110122222110201221112222110020121011111111111111111
1111100011111111110111a10111110110111000111101110111111111010111111111111011111111a11011110111111110011111111111221212111211021111222122222111111110111110011111
1101111011111111101111a10111101110010011111111101110111111001001111111111011111111a01111111111111101111111001102012112121012201221120101100211111110110011111100
1110101011001011101111a01010101011101001101110111111111101111111011011001111101011a11110111100011101111101111100112122102121200210012200221201111111111101111011
1111111111111111111111a11101011011110111111111110010111111111111010011101101011010a11101001111110111101001111100221222200212211202101202102021111111110111111011
1110101010010011110111a11111100111010111110011101111111110111111111010111110111111a10101101111111110101111111111022112210201222121112222222221011111111100111011
1111011111011111011111a11011111011011100110101010111111101111111111111111100110011a11111110111110110111110111111212112102101201120022111212001111101111110111011
1011101011110111111011a11001111011101111101111011111011110111110111101111111111111a10111001110011111111111111111100212112220011112122021002011101111110010110111
1100110111011110110011a11111111111111011111111100101110101110011011111101111111101a01111111110011101101111111010212222022001212220222121101221111111111111111001
0011101101111101111001a11010110011011111011111011111001111011101001011111001001111a11011110111111101111111111110212121200111010122122201221100011111111111111110
1001101101111111111010a11010111111110110110111100111110101010110111100011011110111a10101101011111101101101101111110212101111102211221102211101110111101101111011
1111111110110111000101a01111010111101111110101011010011010111100101111110001111111a11101111100111011001111101001201111222111001212020111101221110111011110111101
1101111010011011001011a11111011011111111011011011011011110011111101111111111111111a10111111111111111111111111112021211120220021021220211222120111010101111111100
1111111111101011111111a11001111010010101111110111101100111011111111100000010111111a11110111111110111001110111112122201212022211202211001001011111011110111101011
1011111010110111110101a00101011111011111111111111111011001101111101011111111110111a11111011111110110111011111101010102121210121201021111011121010101001111111110
1101111110101011010111a11101101011111110111100111101010111011111011110111111110001a11111011111111111101101111111111101110111011101111111111101110011111110111101
1111011111111111011111a11111100111111101011101110011111111111111111110111110111011a10111111110011111110011101111111101111101111101101111101111011111110101111110
1011011111111010101111a11111110110111101010110111011011111011011101101111111101001a10111000110111111111111111111111111111101011011101011111010111111111011001111
1011010111111111111111a11110111111100011111010111101111011001011111101111111110110a11101111111110111111101111111111100110111110111010110111111110111101111101111
