(148, 103)
(4, 104)
(26, 85)
(146, 108)
(25, 75)
(48, 38)
(86, 111)
(43, 70)
(92, 62)
(94, 95)
01001011110110111100110111011011111101111111000110101110111111110111010a11111111010010011111110a11111011101010011111100101110111011111111001110111101110101a1011
00010111101111110111011011001111111101011111010011111111111110110011111a11111111011111011111111a11101110111111111011111101111111111111111100111111111111011a1011
10100101101100111101101011111110110011110101101111110110110111110011010a11011111111111111111111a11011111111110100101111011110111101111011011110011111101111a1011
11111111101110010110010111010111111111111111010100111110000100111111110a11101101101111111111111a00110111111111110101111111111001101100011110011011111110111a0111
10101111111111010110011111111100111111110100111101111111011111111010110a11111111111011111100111a10011111110111111111010111111111111011110111110101111111111a1101
11111111111101111111011011000110011111111111101111011101100111111111111a11111111111111111111101a01011111101110011111111111011111011111111111111110010111111a1101
11001111011111101100111111111101111011101011111111111111011111111111110a11101101011100111111111a01010111011110111111111111101111111111011111011111100111110a1111
11111011111111111101011111100001111110111111111111111110111101010111111a11101110111100111011101a01111011011111101111111100110110011011100111101111111111101a1111
10101110111111111001111101111110110111111010111110111000111001001111001a11011111101101101101111a11101111101111110111001111110110111101111001110111101011011a1111
01111010111111111011111110011101011111000111101111001111001111011110101a10110111101100111011011a10111111111111111111011111001111111101010111111111111011111a0111
10101111111111110110010101111111111011111101110110110111111111110011111a11011111111011111101111a11011010111011111100111111011010011111111100001011011110110a0111
11111111101111011100111000111100011110111011111001101111111111111010111a11111111110111111111111a11111111101110110111010100110111011001111111111011011110110a1111
00111110101101011110101111111111011011110111110011000101111100110110011a10111111111111111001111a11111011011111011111111010011111111110101111111111111111011a1111
01111111011111111100111111000111111110110111111011010111111111111110111a11110111111011110110001a11111111111111110111101111111110110111011010101011011101111a1111
11101101110010110011111111110110001111111011101111100100111111111111110a11110111111110011111111a00101111110111111000011011001110001111111111111010101111111a1110
10111111101111111001111011111011111111101111111111101101111111111101011a10100111111110111111111a10001001111011000111011011111101100011011000011001111100101a1111
10111011111110111111011111111111101111111111111011110111011101111111011a11011111111111111111111a11101111111011111110111100011011111111101111011001111101111a1100
01011010111010111010111111110111101111110100111111110011111110111001101a10011111011111011111111a10111101100111111001111011110111111111100111010111010001111a1110
11111111110110111111111111011111111011010111111111111011111011111111110a11110010111111001010111a01101111101111011110111110110000111111100111110111101111111a1101
11111101111100111001111111101111110110011111000001111101111100111001111a11011111101111111111111a11011011101111101111111111001101101110101101110111111111111a1101
11100111111111111111111011110001101111110111111011101011110011101101011a11111111100101111110111aaaaaaaaaaaaaaaaaaaaaaaaaaaaaaaaaaaaaaaaaaaaaaaaaaaaaaaaaaaaa1111
11110010101101101110101001010011110111101100111111111101000111101111011a1111100111111111111111111111100111111101000101111111011011111001111011011111101110110111
11111111110101001111111101111101111111111101011111101011111101010101101a1101111111111001111111011010101101011111101111111111111111111011101011111110011111011011
11111111111111111111111011111111102111121222120112112102221101011000111a1111101111111110111111011011011110110111111011111010111110111100111011111111011111110111
10111101110011011111111111010111120201212121021100021012100102110111111a11011101111101111001011110111001111101001011111aaaaaaaaaaaaaaaaaaaaa11110111101100111111
00101101110011011111101111111111112211121110121011112210111222011111101a11111111110110111111111111010101101001110111011a1111111001111111111a11010111011111111111
11111111110111111011111111111111021220211202122110021120222012011110111a11111111111110111111011001101111110101111111110a0111111111111000111a01011111111111001010
10111111010111111110111101110111121111121111021111122221111102000011111a11111110111110101111111011011111101011101111011a1010110101111111010a11011111111110111111
11011111110010111010111111111110111001001112212200112022000212011001111a11101111011111100111111110111101101111110111111a1111110111100110110a11111111111101001111
11111111111001100101111010110011120202002111121211211121221120101111101a10110110111111010111101111011011011011111111111a1111111111111011001a11100101111111111001
01011111111110110110111111111011001210202121112121112211221011100101111a11111101111111111111111101111111111111111011111a1111111110110101111a11111100101010011111
11111101111011010111111111101101110111210210220122110120102202201011100a11111110111111111110111111110110111111011101110a0110111101111101101a11011110100101111100
10110011101111111110111110110111120021201112221112112222011111210111011a01011110111011111111111101011101111110111111111a1111111111010010101a10111111101110011111
11111110101111011000101111111011110012210002211010202221122212111101111a11111101110101011010011111111111110111111110111a1110101111010111111a11101011111101101111
10001111011111011110111110111101121112121221211112112211121221211111101a01011111111011011111111111101100100111111111010a1111111111011111111a01111110101110110111
11101111110101110101111111111111102222110202101211111112211102201111111a11111111011111001011101101111111111011011110111a1100101111111101011a11010110111010110001
11111101111101111110111100111111111010022121112110122212020102111111111a11011111111111111101111111111011101111011111001a1011111111001111111a10011111010110010110
10111111110111011111101001110111100202010221110112120011111021110111111a11011111111001110101101011111111100111111110111a1111111111011111010a11111101111111011011
10101111111111111100011011011110022020210112221211112222000210211111101a10110010101111111111010111001111110111110111111a1111111111111111101a11111011111111111111
11110111011011111111110011111010122112102220122122220112021112011010011a10011111111111111111111000111110111111111111111a1001111101010101111a11110111101011101111
11110011111111111111110010111111020201202221221122221112212200011111100a11010101111011111010111010111111111111111110111a1101011011001111111a11110111111111111110
aaaaaaaaaaaaaaaaaaaaaaaaaaaaaaaaaabbbbbba212121122221222122122201110111a11111011111111011111111111111101110010101001111a1111111111011111111a11101111111011111011
1111111011011111111111111101101112021021a110101020011112211212111101110a11111100110111111111110101111111111111111011100a1111111001100111110a11111110111111111111
1101111111111110110011111111101012221111b110010112200102121221111111111a11111111101101111111101000101111100111110100110a1111111110111111111a11111011110111101000
1011111111110111111111100111101001102022a011221121212111001002111111110a100110111111110111101011111aaaaaaaaaaaaaaaaaaaaa1101111111111110111aaaaaaaaaaaaaaaaaaaaa
1011111111111111010111111011101111202122b122111221210101221121011111011a011110111011111010111111110a111101111010111111110111011101010101100111111101011011111110
0111110111000011111000111011101011001111b121121121211101112111211111111a101111111111111111111011011a111101110111111101111011101111111111111111100111110001101011
1110110010101101011001111001011002101222a200002121110012012122201101110a110112211212122001211012021b210121211011111101001111110100111111110111011110101011111010
1010111111011101111111011110011112111212a122121122111221110122210111101a111111201220120211121102222b221102111111111111111111101011111111111110111101100011110010
1011001111100111110111011111101111122222b200112101012121012121211011110a111112002222222112112222101a201012010111110101110111111111111111100111110010111011110111
0111011101111110011110111111111010022121b100220211022212000210211110111a111112201200102221122112112b222212000111111111111111111111111001111101111111111111111111
1010111011011011000011110011010101110021a202121201101011211012111110111a111111221120221210002100022b022022111111000011111101111001111110011001010001111101101111
1111110111101011111111011111001110221211a210101122101022221122110110110a111110101101101201202221121a022002111111110010111110110111111111100010111111101111011111
0111001111111011111101101100111110110111a100111011111111110100111111011a111011112222220212121121221a202021111111001111101111111011101011111111111111111110110111
1111111001011111111110110011111110101110a111101011110101111111111011101a111100221212111100220201020b002212211110111111110110011111101010111110011011011111111111
1110011111101111111111010010111002122101b221002011211211101011111111111a011110202221101221010012211b111211011111111111111111111111111111111111110101011111111011
0111111111101111111111111111122221221100a211221221112221211111101111101a110111121012120222002022221b212112101111111111111111100011111101101100111011111100101101
1110111111111111111111111110010022001020b211000120111021201111110111111a000102021220001010122111121b111011211110111101110111111111110011100111110011011111111101
1101101101111011111110110111010200111012a120112210121022121011100011110a111112210010021001201102200b210201111011111110111111111110111111101111111111111111111111
1111110001111110111111011011222122212012b221212111201201121111111111111a101012101022121221110211202a122111210110101111011111111110111111011111110111111111011111
1110110100112222002222102222220201122102b011211112011101221110111111111a010111201111100201211202022b122102011110111111111101111111111110111111111111111100011111
1110111111012220022012212100212212210121b111221211111000211111111111111a111012222021122202200222121a001121111101001101111111111111011111101001111111111011011111
1111001111111222022110200212220222122012b221100000112111110111111110111a111012221120211202110210112a111202211001111111011111111011111011111111101101111111110111
0111110011220122222221101000122222202022a111012222111202211011110101010a111011121011111000211011222a202111111110111100111111001010101111111111111011111111101111
1111111101111201101012102121022211120211b001100210220202211111111111111a111111120120220102121111121abbabbbbaaaaaaaaaaaaaaaaaaaaaaaaaaaaaaaaaaaaaaaaaaaaaaaaaaaaa
1111111001212110110211101212012221221212a222212111002112110111110011101a0111101211011222222222102222222212100110111110111110111110110001011111110110011111111001
1110111111101201210221221120122202022122b120102102220212000110111111101a1111102202221100220022122212110101210100111010110011011111111110011101011110001110111011
1111111001220011012111222011220201022100a211002012112121121111001111111a1010121112110122101102220122111112101100111111010111111101110111011111110001011111101111
0110111011111121112120201220112112111022b102222202111212201111111111111a1111111221220210211101221111200201010010101110110111111111111010110111111111110111101110
1111110111222202221202122121122002012002b202121110201211200010101111111a1010112211101121211121110222212102211111111011111110111011110110111111110100110111011111
1111101100122221120200012001010200222222b222112012200110121110101001101a1111110111021211111112221121221220211011000110111110111110111111110111011110111111011111
1111111110201020220222122121222022100002b120210102022112221011111011111a1111102222211210102211011221212022211111011111111010000101110111011101111111111111110000
0110111101112201221221202212222221002200b211011202010100211111110111111a1110112021122122201202210210121121111111111111111011011111111011111110010111001111111101
1111110111022002100022202220002002020122b122122211111001201111011111001a1011022102212202112000112121210122210111111111111111010111111111111101110111110111111011
1111101011122222020222221020020222220002b221211222102021221111000100011a1011102210202222010021112011210011010101110011110101100001111111111011111111111111111110
1101110111222222222122211012222212002222a211211221110222201111111111010a1111121022011112120211110102001221111011111101111111111101001111111101111111010110111101
1111111111101200221202120022202022202222a212102120121222021001110111101a0101112221011110012212121101110200111111110011111100111001111111111100110110011111111101
0101101111202220222212122220222022222222b100201122111221020111011101111a1110111011101110011111111111011111110111101110101111011110111110100111101110111111111011
0110111110212122222102210220222020201200a211222121001211221111100101111a0100011011010111111111111101101110111110111111111011111011111111101111111111100101011111
1111110111220120212202222001222202221100a202221121221111121110111111111a0111111111111111111110111110101110111111011001011111111011011100111101111101110110101111
1111111011022020022222000120222212022122b120210220002211101001011111111a1011011211101112102222210211122121122011111101111010111111111100110110011111101111111010
aaaaaaaaaababbbbbbbbaabaabbabbbbbbaabbbba010110222222212220111111111111a0101111101021201221021001210022011011100011111110111011110111010111011010111010111110010
11110111002022202222222220020222202212221021112121011211220111001111111a1110111222122220112122011220021110102111111001111011110111111111111101111111101111110111
11111111112210022022220022120202202022002022122221211212001111111011011a0011111202222112222012222111211120202100110111011101111101101110011011100001111000111111
11111110010022220122210220022202221222102112120202221212221111011110011a1111101011021110110210212212120122221011001111111110111111110111111110111111111111100110
11110101110221221222122200112211222212121111111111111111011111111011111a1110111012222222222001121121221021212101011111111111011111111101111111111111010111111110
10101111112002222011222021122021222220221011101101111111110001101011111a0011111101022122220201210211110121101111111100101011110111010111011110111110111111111111
11110111102220222220022222222220022101212011111011011110111101111101111a1010111212221120111120012021010102011111011111101111111101111111101110110010111011111011
10111101111021212122202122222220121212220111111111110110111011110101111a0101111221122121120101121211000112122011110111011011111111011111111111111111111010111111
11111111111222212022002110112102002211222111111111111010111101011111111a1111110111022102111221010221112122022101111111010111111111111110111110101111010011100111
11111111111221212122200111222021212111122111111100111001111110111111011a1101111110220222111121222021221122110011001101111111101111111111101101100111110011111110
11111111111122112202122212112111110222021111111011001111111011101111101a1110001111011212212112212122002101211111111110111111011100111111110111111111111111101111
01111111111101101211101002212020210021212111111111110011111110001011111a1101111012201120121102212021100122122111011111111111110111111111101101101011101111111110
11011101011110021222112212012222122121012011111101101001111111111110111a0010100200112202222111122210201122111111111011111000111111122002111121211211112021121122
11111101011121111000112222222110211221010111001111001000111101111011111a1101111222211210121011120221112010010111111111111000111111111112100121020202111221012210
11111111111212221112011211120212100110121111101110111101110000110111111a1111111012200022201201111201221211200111110000010011101101112001222020001021201021201111
11111110111200211212201221000212012111112111001110111111111101001111111a1200021212002122222022002221001202220010101111111111111111112222221111212112221011111000
11111101001202222221112212111212120111201111110010111111111111110111110b1112120202202000222020221100101221221111111011101111111010011121122222222212111110111211
01111010111122211222101001012111122102201110100111010111111111111010011b2211012221122221222022202120001220122000001111110111111111102220122021112210112121200102
10111110111112102000021211100222100011112011100010111111111001111110101a2121112222212212202200122002220102111100111111111111011111112212212120221211212111211222
11111111111111101111111010111101111011110111111111111111111011111111101b2101222022221122222010022222220112021011011111110101100110111202222222110221222221012120
01101111011011100111111111111100111110110111011111011101101110110011001b1102222222102220222221221022211222011111111110011110110111100201120210222202122212111120
10111101111000110101111111010011011001110101111110111100011110110111111a1221222110202222122212022100112221011101101111111011111011112210000021221112121202211220
11101111111110011111110111111111100010111111111111111011111110110110111b2112102220220222020221222222021222222111011101111011111011021200011112102022110110122122
11011101011111110111100001110111101111111111011111110011111111011111110b1121110111020211222222102220211122021111111111111011111010111221022112212222120022121002
10111111000000110011110111011111011111101110111110111110110110110111111a1020001012222221221222220211221210012111011111111110111110110211020211210110112212200112
10111001101111011111111111110111101111111111111110011110001010111110111a1101001022202022012202112220011112022111110111111010111111101212121010222121222012220011
01111110110111001111111111111111011011100100111110111010110100011110111a1222010202122122210222222220221221212110111111101111111111111010212210022022221102222222
10111101111101111110101111111111111111111110111110100101001111111111111b2220112221202220020121222012111202010001101111111111110000122221220011210222102200121110
00111111001110111111111010111111110111100110111111111111111110111011111b2112021220221220222221222021212111120111111111111111111111101212220101102222220101211100
11111111111011111111111111110111100101111111111111111101101111110111110b1101120011120110101101111101111110110111110111111111101111122112220201111201110202200100
10110111111111001111111011101011011101000111101111110111111110111111100a0122201021220112122212202112211110111111111110101111010111112111112120012112202212011212
11101101111111000011111111011101111111111111011010011101101011111100111a0221122211111212222212220211111101011111111110111111011111111222111211202120012101110202
11111110111011111100101011011111011100011110010010011111111011101011111a0102001012221222112212221122211001111101101011011111111110111212021112102220110001112011
11101111111011101111111010111111110111111101011111111111111011111111001a2112222121021121202021212121000111111111111111111011101111011111220021212122200221121121
10110011000011011011111010100111110100110001111111101111011111110111111b0021021020010110111211111012001111011111111011100111111111121110200102122102102221211122
10111111010011111111110101011111111111011100111111011011011101111111111b1122201211121222201112212120210110011100111111110110011100100221022211120220210112011221
11111101111101110101101111111111111101100111001010011111111110010010101b2112210011221221011202111112111010011101111100001101110001112022222221202011200121201121
11111101111110111111011100101101111110111111111011011101111101001011111a2211220112101210012212120011011101111011001111011001011111121021121221222211222202212212
01111111001111111110101101110111101011111110111110111111111001011011111b2002121101021010011111212220201101110111111111101111110011122222020220110201221210122220
