(149, 15)
(9, 115)
(116, 36)
(71, 1)
(28, 15)
(129, 18)
(53, 6)
(136, 59)
(6, 67)
(156, 61)
1110111000110222111111110101102100210220200111112211120211220202120112202221220210112211111001111111111101111a01111011111111011101111111110a11011111011111101100
1111111111111102122202202220222112121220012111111211111002001222221211022021212111122211110110111111100111101a11111111111111111101111011111a11011101111111111110
1111111111110110121012012220111101202002202221102211120120221221020121211111211220112011110110011111111011011a01110001001111111111101111111a11111111000011001110
1111101011111002001111002220212222120222021102121221110220002112202212100111121212211011011111111111111110111a11111111221021221210120222221b01211110111111101100
1111111101111120121011122112222212110022022211121210210220000012222212110111201011221111111110111111100110111a11010222011212222110112202102a00021011111111111111
1111011011110211222222021220221201110102222122112111111102020221202010011120022010212110111111111001111010011a11111001212112212222020102001b10211110110110111111
1011110101111212121010212221222121211122210111202101112120212002222211112111002011122101110111111110010111110a10111220220002021100112112121b21210011100111110111
1111101111111121110110012121121122121222222112122222212122210012212110100112121001100211111111111011101111110a11111211112122011202122120202b21121111111111011111
1111010001111222200222120222122102222001222121111222211122202202222210221202112112211211010111101011010011110a11111112212102120122102122112b12211110111111011111
1101011101111212012000111012011120110120222221201212222202212000102122121022211100021011011101110110110111101a11112210122211211220021102220a10210111111111111110
1110110110011102122221012111002221110002212212112101100121122212222221112000012222022011110111111111110011101a11111122012111221012122101210a02121110101111111110
1110110111111212221121220020222202112002222221221202211121222012002212010202121212221211011111111010111111100a11111020222012202221211022000b12211111111011101111
0111111111100110021100022221221221212120001201021022111221212202222222101120111012112001001111111111110111011a11112012110121111212221011120b20121110111110011111
1101111111111111012021220220221102122100222102022210122202012102222211121212122021202211001110001011101110101a11112211202112200210210201210b00111101110111101110
1101111100011221222120110212212022120201121220222220020222202221120222122211201122102211010111111111110110111a11112021222121111102211122121b10111001111111111100
1000111001011200210212222120111112121220122221221020012012022120122122111112021011012011110011111111101111011a11102002201102111221212111012a12111111110111101111
1101111111111111101020210122202221022212102212222210122022011122120211111110001011100110101111101110011110111a11012021220110120110200110210b21211111111001100110
1110111111110122012122221110111112221020222210112222201011101220010211101100111111111111110110111101111110111a10111212221201102200121222202b11220000111111011110
1111110110111100002100111221122102201011020212202021022211212012000010011111111111111111111110101111101111100a01111222222110011111110221201b10210101110110111111
0101111111111011221201111122201002101121222121101112122211221111111211110010011110111110011111010111101110111a01100210112221112002101112200a10020111101111011111
aaaaaaaaaaaaaabbaaabababaabababaaabbaaababbbabbaabaabaababbbaaaabbabaaaaaaaaaaaaaaaaaaaaaaaaaaaaaaaaaaaaaaaaaa00112222212102212120112002201b12220001101111101100
1011010111110212212210121121121212222012211010110011011111111111110011101111011111110111101111110111100110200010121201221221222222101021010b01201101101010110011
1010111001111220221121110212021111222210211111111111111111011111111011111101001110100100111110110011101122010112212202221002020200201022101b11200111111110111011
1011111111101120101221112112111121120011211011110111011111101011111101111111101111111111010110111001100102211111222120202112022111210212221a21201110101101001111
0111110111111212112020210011221011221211010111111111111111101110111101011101011001111110111011111111101011122122112221000210102211122222210a21211101111011011011
0111011110111222022010101102112121221111122111011101100111111110001111101110001011111001111110110001120002222011020221112222202202010221021a12211110111111110100
1111110101000210221011112201011120112120010101111010011111111011111011111110111111011111110111101111102012021120121121222020202022210011122a12021111001111111111
1111111001111122111220001222102212111220211111101111101011111111101111111011011111111111111011111111021210101102110211222002222222211211220a22021111110110111111
10010101110111220221011202022121200021021121111111000111111111011101001111100101111111111001111011111120221122200012222bbbbbabababbabbababaa12220001111011111111
11110111011111120120212021212110110222112121110111111111011101110111111011111111111111011100011111110202012021120122222b1002221212221222002221021111011111111110
aaaaaaaaaaaaaaaaaaaaaaaaaaaaaaaaaaaaaaaaaaaaaaaaaaaaaaaaaaaaaaaaaaaaaaaaaaaaaaaaa11111111111111111011211011200112202202b2222202202222211012212121110110101111100
11110110111111111110101001111111111111111111010101111111111110111011111101011101a01011110101110111111200020112120121222b2220102202211121021012211101111111111100
11111111111010111101111001101110101101011111101110111111110111111111111111111011a11111111101111110111212011201222120222b2222022000010012222220111010111110111111
01111111111111110111111101110011111101111111111111111101101011111111111101101111a01100111001111011011212220202011121222a2122012010211111111111111010111111101011
11101110011111101000011111011111011101111111111100111111111101111111011010101111a10110101011011100111121102020111120222a2112121212111111111001111111001101011101
11010110111101111111101101111010111111111111111110110111001111111111111111001111a10011101111111111011012122210112011211a0020222122110110100110100101111010111001
11111100011110101111111110111011111111110101111101111111011111111010111010111110a11111111011111111111102111010012222122a0111211122211111101111111100011111110111
11111111111011011111011011110111111111111111111110101110110011101100111101111111a11111001011111111111220022220212120111b0100002012210111111100001110111111010111
11111111101101101110011011111101111111111111011111010111011110111101010111111111a10101101111111100111121212120020110211a2102010202211111001111010111111111111000
11111111101111011111110111111111011011101111111101111101111001111101111101111100a01001111111111111111212112102102021122b0201120012110111111111011110101111111110
11111111101111110011111111111111111111111111110100111111100111001011110111011111a11110111111111011111011202210222222000b1021220212011111111011011111111111111101
10101111111111111111110100001111101111111111011110111010011111111100111111101111a11111111111111101110222121221201200020b0102102210110111101111111110111111111111
11011001010001111101111111110111111111011110111001011111111111000111101011111111a11011001001011100111101212222111221202b2121122211110011111111111101111111110011
11111110011101111111110001111111011111101101110111111110101111111111011101111111a00111111101111111111101002112120021202b2011220122111110111011111111011111011111
01111010011011101110101101111011110111111111111101111111010111010111111101111101a11011111110110100101121020221111011011b0021120222211111221211102122011111011111
11101111111111111111101111111110110111101111111100011011101010110110011111111110a01111101001111111011222020200110222211a2220221121100012202220012122020111111010
11111110111101111111111111111111111101111110111001110111111011111011111111100111a00011011111111100100021220101010122022b0002222212002012121122222021212101221211
10010110110111101110110110101111111111111111111110100111111100111111011110111111a01111111111011011111220222222112112002b1222222220220011202111201202000012221110
11111011111111011101111011101111111111111011011111111011101111111100111111110101a01111111011011111111121202102000222002a2122221021222200200200221222222221212212
01111111010011110111101101111111111111111101101010011111111010111111111011010011a11011101111111111110111211021211200101b1212220202202212222001212120020211012201
11111011110111001110110101101111000111110100110110101110011100001101000011011111a11111111110011111111112122201111101111a2200200021212002122010220212221112212211
11110111101010011111111111100111111110101101011111110110111110001110101001011110a11011111111110101011101101110111001111a1020122112002221202021201222212211220200
01202021210101000110001111111111001111101101111111111111111101000110011011111111a10111011111111111110100111111101111111a1221211011222122021200222220202120122212
22122020212121200122211111001101111111111111010110110101111111011111111110110011a11111011101111111011011111010110100110a1102020102011101220112222220122121112001
11021221221122220222211110111110011110111111101111110111101001110011111111111111a01111111110111111111011111001111111111a1120221121022101220122200020011122101120
21220210221211221221110111111111111110101010111110111111101110111111101000110111a01110111100011101111111101011010101111a1121011221111122011111212120201121112112
10122021020212221002111101101011111111111010111101001111101101101101111111101100a11111001111111111101111110111101111100a1211222001111202202010202102202221212101
11111011210211000022211111101111111111100011111110111011011111111111111111111001a10111111111111111111001100111011110111a1211101211022121020022022112020002222210
21121212110021021220101111100111111111111111101011110100111111111111111011111110a00111111110101111100111110101111111111a1221011120122111202100222222220022102012
01110220221211221212000111111111111011111111111110111101111110101011100101110111a11111111111110111101111111111111111111a1221002211111211021120022102021122122111
22120012122222011012111111111111101111111011111010111111111110111101010101111110a01111110101111111111111110010010111111a0122222121222202201012022122022211212211
12102101002120122110111010111110101101110111111011011111111011111101110100110011a11101100111111111011101011010111101101a1012021220112111021222222201122121112010
10201121010221102221011111011110101011111110111111111111111011111101110111011111a10111111111111111010111111101110100011a1102212210101221200202020220010012111012
12102101110022111112211011001111011111111111111111001101111101111111111101000011a11000111111111111111111111011011111011a1100101100021021020112102211012122022121
12011111212102021112201011111011101111111101111011111101011111111101110000011111a11011111011101011110101011111001110111a1212221121002112202201220121211211212202
12012021121021101111201101101111011111101111010111111100101111111110111111000111a11111111111011100101101111110110111110a1220022211021212112101201200022202112021
12212211222121012101111111010111111111110111011011011011111101101111110011001111a11111111110111100110111011111000111111a1221021211210212212210222222220021001210
21111221112120010100011011110101111111101011011111101011101011111111111010110111a11011111111001111111101111111111111110a1002201112201112211202022121122222011112
22121120211101222111200110110110111011011010101111011011011110111111011111001111a11101010111011110101011111111111110011aababaabaabbbaabaaaababbbbabbbabbbabbbaab
12222212110201002122211101111111110111111101101111110011101111111101011110011111a1111111111111111001100110111111110011011102210111221212222122222221222210121111
babaaababababbbbaaaabaaaaaaaaaaaaaaaaaaaaaaaaaaaaaaaaaaaaaaaaaaaaaaaaaaaaaaaaaaaa1111110111011111111101111011111111101111021122102211011120122202201020112222200
0111201120210210201010111011111101011001111001101111111111111100111100011111110101101110111011111111110011111010111011011120222012120120101222120222120201110001
1211210212112102120221010101111101011111111010110100011000111011111111110111111111111111110111011101110100101110111100011012221022110202212202100220202122201222
0212221111122111220210111111100110111110111011111011101001011110111001111111110111000111111110110101110111110111111101110202212220002102122202221122122101021100
1011201221222211002221111111111111110111101111011011101111011111111111011011000111011101111111011000111011111011111111111110101110011111111112012111121112222221
2220212211112102111121101011111110111111100111111111011111111111111111111111010111111111111111111111111101111101101111110011010111011101111012111221122010011120
1101120121122012000201110111111110011111111111111111011111001011011111111111111111111101111111111110101001101010101011110111111011111110011101111111110101111111
1112002211212220211011010110110110011011111101111111110101111110111111011110111111110111100111010110111101111101101100011101011111000000111100111111010101011101
1010222212022211222201111101101111111101101111110111101011111110111111111011111111110110111111100001101111101101110111111111100110111111110010001001111101010011
2102202111112110121200111111011111111111001101111111011110111011101110111111111111011011111111111111011111101011111111111111011101110010101001111011111111111011
0010002202121122122211111011111110111101111111110111101111111010100111011101111111111111111111101111111010111110101101001111110111111111011110110111111101111111
2121112221111212221011011001110011011111111111111111101001001110010011101111011111011101110110110111111110111110110111001101111110110111111011111111111111111101
1101101111101111001110100011101111110110011001111100111111111111011111101101100110111000111011111110011111111111001101111011111111110011011101111110110011011111
0101111110110110101111111001111111111111111111101011111111111111110000111111110111011111111100111111101101111110110111101011011111110011011101101010111111110011
1111011111111111110111111110101011011011111101011111111111111011111101001111111001110111111110111111110111100111001111001100011111111111110010111110010101101111
1111111111111111100111010111010011110111111111110111100111111111111011111011101110110101111111110001111010111101111111111011101111111001101111111001101011111101
1111111111111111111000111111111110011111111101111101011111101111101011111101001100111110110101110111110101111111111001101111011110110111101111111111111011111110
1111111110110111111100111101011011111111110111011111101111111111101110111110110111011111111101100111110111111111111101111111111101111111110111101011101110111011
1011101100111111110101111111111010111110111111110111110110110111101111011110011110111111111111111111111110111010111111111111111011111111111111111011111111111111
1011100111111111111110111111001111001101111110000100011110111111010011111111001111011110111111111111001100101111111100110111111011011111111101011011011011110110
1100111011111011011111101111110110011110001101110111011011111111011011111101111111110101011111111111111101111111111111111111111101110011111111111101011111101111
1110110101111101111110111011111111111111111100111111100011111001101111110110111100101001111111011111111110000111111111111111111111110110011011100111111111110110
1010110111001011111111111111111111111101101111011011101111111111111011110110111111110001110101110111111111110110111110111101110110111111111110111111101111111110
1101101111111111111101101011111101111111111101111111111000111001101111101011001111111111111010011111010011111101111011111111101110111111110101101011011101101101
0101111111011100110110110111111011111111111011111110100010101001111111110011110111001111111011111010110111101111010101111100011111111100101111111111111111111111
1100111011111101111011101010111110111111111011111111110111011110100110110110100101111111111111111101001011101101101011111111101101000111111111011111111110111110
1011101101111111001100110111001111011011101111101111111111111011100111111111111010100111110111101101111111111101110011111111110011011110111111111010110101111111
0111111110111011111111110101111011111111111100110111111111101111011111111110010111001100111111111111101001111110111011111111111101111111111111111111110111101111
1110011011100101101011101111111111111011101111011111111111111011111110011110111110111111111111111010111111111001111111111111101111100111111101101110011011011111
1111111101111011111111111011011110100111101010111011111011111111111110110100111110110111111110111101111101111101111111111001011010111111111111111001111101111111
1111101111111111110101111011011011111100101101101111011111111011111110011111111111100101111101111111111111111111111111111101001111101101111101110111110111101111
1101111101011111111001101011101111111111101101111111111111101111111011101111111101001011010011000110111011100101101101101111010011111011111111110101011110110101
1111111101111011111111101101111101101111011110110101111111111111110111001111110111110111001011111111111101111001111111111111111110001110111111110110011110111010
0111011110010111101010110011001011011011111110111010111100110100101111110110111111111111011111111110100111111111111111111111011101110011111110110111000001011111
1110011111111111101111110111111101111111111000110111101110110111011111111111010011011111110011111111111111111111111011111110011111011110111111111011011111011011
0101111010111111111111010110111111111111100111111111101111111101011101111011111011111111111111110110111101111111010001101111111111111011111111111111110111101111
1101111111111111111011110111011110111111101111110111111001110110111010010111110001111110111011111011111110111110111111111111011111110111111111101111111111111101
1110111011111111011111110101101111010111111111111111011101110111111101101111111111110110111111111011001111010101111110110111101011111101111110111111111101111111
aaaaaaaaaaaaaaaaaaaaaaaaaaaaaaaaaaaaaaaaaaaaaaaaaaaaaaaaaaaaaaaaaaaaaaaaaaaaaaaaaaaaaaaaaaaaaaaaaaaaaaaaaaaaaaaaaaaaaaaaaaaaaaaaaaaaaaaaaaaaaaaaaaaaaaaaaaaaaaaa
1111101111110111110011111101111101100111110011010011101111111111110001111111100110110111011111111111111111101011011101010111111101111111111001101111101011111011
0111100101011011111111011111011111011011101111111111111011111111101100111111110011111110111111011111011101001111011111111111101111111111111111111101110000110111
0110111111111011101101111011011111110111111101111110111111101111011100111010111111101011011100101110010100111110101110111101111110010011101111110110011011011011
1111111111111111111111101111100110011111111101110011011111111111111111111101110111111011011111111101111101011110111111111111001110001111111100001111111111011111
1101111001111111011111111101111010100111111111101111111111111101001111110011101101111110111111101111110111111101011110010101111011011101100011001111011111100111
1011111011111101011111111111111101101110111011111101111111111111011111111111111111011111111111111111111110110111110111010111110111111111100111111111111111001011
1111011111101111111111111101011110111011111011011110111111111010101001001101111111111110111111110111101110111111110111100111111111111011110110111001111111011101
1110111111111111011111111010111111111101011111110111011011110110111111111111111110011111111001110110110110100001111011011111111111111011111101011111011111111111
1111011001110100111111111101111111101111011001111001101111111101111111011000011111111011110011011111111111111110110111111111011101111111101110110011011111011111
1010011110110110111101110111101111111110001111110011111110111001111111111110111101100010101111111111111110110111110010111111111111011110100111101111111011111111
1011001010110111010111101101011111011101111111011110111111101111011111111111110011110111110111010010101101111101111101100111111111110010111101001111110100110111
