(5, 105)
(18, 1)
(60, 115)
(48, 58)
(131, 65)
(21, 22)
(145, 116)
(77, 69)
(69, 3)
(90, 39)
11011110111111101101111011a111011111011110a11101111111122101211122112a010111222122220111111110011111111011001111111111011111111011111111111011111111010101111111
00101110101111110111011101a101110111011101a11001101111222201220210212b212211122011120111011111111111110111010101111111110110001111111001110010101011101011100001
11001101011101100110111110a111101101111011a01101011111211111110211011b212120111121011100011110101111110111101111111111111101111111110111111111111111111101111111
11111111111111111111101111a111110110111101a10111111101222222120220001a112110221110120111011111111111111111111111111111101110101111111011101101101111111110111100
aaaaaaaaaaaaaaaaaaaaa01111a111110111110111a10111110110211101122021220b211121211221211011101111111111111110101110011111011011110111011001111111111111111011111111
01111111111011111011a11101a111001111101010a11111011011011112011021122a110021011212221111110111101011111001110011101110111111110111111111100110111111010111110111
11111011111000110101a11111a111111101111111a11110110111021012222111101a221010121100101111110111111011111111001111111101110110111101110110101111111100101111111001
11011122021002221211b12022a202102210100011a10100111011112022210202222a202022120111021111111111011001111100111001110110111111100111110111111111111011111111110111
01101002212211101002a00102a002122020111001a01111011101012201122022121b122221100111121101111101111010100111110111110011111111110111001110111011101111111110111101
11110120102112121222b01001b221222122111111a01111110011212222112212011a122000122211111101111111111111111111101100111111111011101010111110111111100111011111110111
11110110220212222110a21220b112221010111101a10111110010211202122102020a021102102101210111100011111111111111110111111111011010111111111111111111101111110111011011
10111101112220211211a00122a110220100111001a11011010010212122120212111a022122021100221110101100111111111101111110111111111111111101101010111111101101101010111111
10110101101120101021b21222a102222210111110a11101111111210112222121111a221100102102121111111111111111111111110111101111110101011111111101101110110111111110111101
10111021122222111211a02100b220222220111110a11111011111201112201210101a222211222112221111111011111100111111111111111111101110101110011101100111111111111111101111
11111122210112122121a12221a222021201010110a10111111101220122211101112b200122000102111111111111111111011010101111101110111110000011111111101111111011101011101011
01111021002101112221a11112a120201112110011a11111111110220111122201220a020211000112121101111010111111111111010111111111111001111110111110000111110111011110111111
11111001112201121022a11002b001012022111011a01100100001111212000110221b102212212121021110011111111111110110001101111111111111111111011110111111111101001101111111
01111112202211222020b22001a122111222110111a01110110111002021100001022b100111212110101111101111111111011011101111101111111101011111011001111101101010101011111101
11111120211010102212a21110b121101212111111a01111111101111110101111111a001011101111111111101111100111101101110011111011111111111011110111110111111111100011111101
10011020112210211121a21122b021220112111101a11111111111111011110111101a111111110111111111101011101010111111111110011101111111111000110111000111111110000101111011
01100112012202012100a01201a222221002101110a11101111111111011111111111a101101111111011111111111110111011111101111101111110111110111101111111101111011111111111111
11011101122112112221a12000b010121112011111a11111111111111111111111110a111111101111011110010111011111110111111110111101110011010111011101111111011000011111011111
11011101212011121110a22002a212210112101111a11110101110011111100011111a100111111110101100011100111001111111110111111110111011110111111110111011111111101111110011
11111011120122111222b01202b112102120011111a11111011110101111101011111a101111111011111111011111111111111111110111111111000111011011111111111110110111101111111010
11111122201211011011a02102b010012201111110a11101101111111011110111111a011102211002110222112012121112200111011111111111110111111111111111111111111111111110011101
11100110122221222112a21000b211210200011110a11110111101111101111101111a111112122200020011112121002220221021011111110111001011010100011111101111111101100011111111
10111100210122021221b10101a222210021101111a11111010011101110111110111a101100100011212202122112222210111021011111110101110111010110111111111011111011000001111111
11101100212111000010a20022b222022220111111a10111101011011111001011100a000112012222002112011221121101112221111101111110100001101111111101101111111111111011111000
11111022212122211022a02221a210120222111111a11100111110101001111101001a111112122221211121222121112101222211111101101011101101101110000011100101011111111101111111
11101111211112201011a11110a211022221011111a10000101111111111001111011a101012102011002002122112221002102121111101111111111111111000011101100111011111111111101010
10011121210212100211a20221a002010221111100a11111011111010111011111101a111110211220121122021102222202122110110111011111111111111111011010010101110111111111111111
10111021122210121011a10222a212022101011011a10111111011111110111111100a110111121022221122222200112022111221101111110111101010111111101101101111010111110111011111
11101121021122122222b22202b112121011111111a11010111010111111110110111a111102120200002020111112122122202221111011111111101101101111111111101111111110011111111111
01111111122021102221b12222a212001201111111a11110111111000111011000110a011110020002122221222222222121011021111101110101011111111011010111010011111100111111111111
11010111221221212012a22202b222111112101111a10111110111111111111011111a111111102122121011021222220122110111101111111110111110011111110111111111101110101111111111
10111111222212201102a02222a212221011111101a11111011110011111110100111a111000212212211212211022220022112221111101111011101111111111100111101110111011111111110111
10111121220101102200a22121b220120120110111a11010110110111110011011110a111111211022102100121121022220021210101111111110100111111111111011011111111101100111101111
01111100010100011111a11111a111111011011111a11101011111101111010111111a111112122212021122110121210201202121011001100101101110111010110111011010011011111111111101
11111011111111011111a01110a111111111111111a10001111110110011111111111a111111211212201221211221210120112211111011101011101011110111111101010111111101101110110111
11111111110101101111a11110a110111111011011a11110111101111111111101111a111112020101122010210111121021121111110111110100111111111111111101111111111101100110001111
11111011011010101111a10101a101111111111011a00100111101111011110111111aaaaaabababababbbabababbaaaaaabbbaabaaaaaaaaaaaaaaaaaaaaaaaaaaaaaaaaaaaaaaaaaaaaaaaaaaaaaaa
11110111111110001110a11111a111110111111001a101111111110101111101111101101111000212122021200211100111122021011101111111111110111111111110111111111111011111010111
11111111100011111110a11110a011111011111111a111111111110110101111111111100110011111221012211211110200211001111011101111111101011101111101111111111011111011101111
11111110011111111111a00111a110011210121010a011112212111211112011111001111111100012122220120202121100020021001111011111011111111111111110100111100110111111011111
11111011110111110001a10101a111101121212112a220100210221102122221101111111011201222112110121202022122122101011001110111110011111101010111111111111110101111010101
01111101111111001101a01111a111010220121012b211210210221110112020111001101112002221102112222211222212011120111111111011011111101011111111101111011101111010001111
11001111111111111110a11111a011111121112011a011111112210202221210100101111101011012101122212022211111101011010111011110111110101110110111101111010011110111011111
11110111111111111111a01111a111111012220221b012220220112211012111111000111111220212200002202120111112212121101001011111111100111010101111111111011111111111111111
10111011111110101101a11110a101111212211101b221200011110212111211111011011012221210022110122121012211222021110110110111111100110101100001111111011110110001010111
11111111111111011011a11111a111111120101021b222012112022121111111110110111110012102111211202021110221011110111110111111110111111111111111111111111111111101111110
01111110011111110111a10111a100111021220012b102222201202122011101001011111110110221211101221120201212101101110111011110212010110022022211210121221210111010111111
11011111111111111111a11101a111101211222112a221022021022210212221111110011110101112122200212112002021200110110111010102021122211022222112120221112010011110010011
10101101111111110011a10011a111111111212101a122121111100122101211000110111110021121102211112110022211212211101111111112101121220011202011121021122111011111111010
11010111111111011111a11011a111111112112220b220222211122001000121011101111012002020202221012202122211221001110111100021222020100112122002222102222211100111011111
11111111011101111111a11001a111101122222101a201010021221210112022101011011011020122110002211201101110111101101111111122111112022111221221211122011011101011111111
11110101101011111011a11110a111111020112221b201111110122102112112121211120122222122112202212211110101111111111100111101122211222212111102211112000111100111101011
01110111111111101101a10011a111111221021111a122122120222111212120021111211222212022022011101111101111110100111111011112100012212101112222100101101011111010101111
00101111101110111111a11110a011111112100121b211012101212112211120012211011222102211220100202111111111111110101101011120211122022222022111101221021210100010001010
01101111111101011101a11111a101111221221202a212111212111210010120111112202122122000120222222111111111111111111111110100121100222200210101122012021111101111111111
11010111011111101111a11011a111111212112112b201111211021202220102121211010121102200212112021211111111111111111111101110002110222211111112100222110111111111111111
11110111101110001111a10111a101111111120121b122220211112110112121121012212210021110212122002211111011011111111011111121222222001222221100212121210211111101111101
01111001010111110010a11111a110100202211111a201122212122112210122111122121102212021121111220111110111101111101111010111212122202021021120210122102211111111100111
10111111101111100101a11110a111111211022112a111011211112012200122111001121220111210122011111211111111110001011110101112221111110022112201202110011111111011111110
11011111001000111101a11110a001011122221110b220021010111110221211122112221121220101022112200101001110111111111111111022222111202121222000112011200011001010111110
11111101111110011111a11110a111011112010201b212201212111010002100222002211011110200201220112111011011111111011111111121101111000200200112112111100211011111111111
10011111101101011111a10101a110110222212212b122111121101212202001121220111112000212111222211101111101011111111111001002220101111102211212011111210211111111111111
11111111101111011111a00111a010011101012211a022221222101210021001220202100211112000222022121211110110111111010101111011101101211101210022212222122211010011111110
11111111111101110110a11110a001110222111212b012121112221112202002102122112211101002121221122210111111111011101111001120202212111212211001211001120211100111101110
11011111111111101011a11111a101111200212022a121201122011201111222200112221212211120122110121111011110111111101010110122112210112200211011221212212211110111001111
11111111110111111101a01111a101101111212212a112122001011112211120122211121011111122201221122110101101110101101111111020012222220120221101210010111011111111111111
11111111100111111110a11111a111011222002122b102220112001021212221221210021112121000221011201111100101111100110111111120222111211122201221100011021000111101011011
01101111011111111111a01111a111111212200102a010202112101221111202222222011020212000102200222211011001111111111111111020102101011112022121111122122111111111111111
11111111110101001111a11111a111110122212012a022020211101122022122102220001122100120002000021210111011001011110111110112121122210221110012211220211211111111111111
11111101010011100111a11010a110111111101110a111101110111111011121112220022220010112122111122111111111010111110111111020212222112021201111222221122001111101110111
10001111110111101111a11110a001101011011111a110101011110111011022011120210011120120122111021011111111110101110011111110120221122110201111202222111110011111110100
11010101011111010111a01111a111101101010111a011111110111110110022101222121211101222122212212211111111111101111101001112112111120212121121210220121111111111111111
10011110000111011101a11111a111111111111011a110111000011110101111122021201111222102221111222111010011101111110111111121102222101211210211222212121211111011110011
11011111011110101011a11001a011111101010111a101111101111100010121221211112221200002101221112101100111111111100110111122012112121022112202000110101011111111111111
11111100111100111101a11110a110110011111010a101111101111111010122221102111111020122201010010011101111011101111100110122201102111212211111201210010111011111011111
10101111111111111111a11111a111111111001111a101111110100101111110120221112100022122110110221100111101010111111111110120220100202012211212202121222211111111111111
10101110110101111110a11111a110111111111111a111111111111111111112212021212012222122122110202200111111111111100110111111101011111111011011110111111111111100111101
01111111101111111110a01111a110011110101111a111001011111111111122011211222222122222200201222211111111111111010101101111110001110000110011111100100100111100100100
11101111100111101011a11110a111011111101011a011110010111101111012112112212110111021021211122201011101101111111111111111011011010001011111100111001101111111111000
00111111100001110110a11101a111011011100110a111111111111101101100122221220221211220112022122011111110011110111110011111101101111111110011111110111111101111011111
aaaaaaaaaaaaaaaaaaaaa11111a111011101111111a110010111111111111100111101110111101010111101111101111110100010110111111110111101010110111101111011101111010111111111
11111011001111011010011110a011111111111111a010011101111011011111101101011111111101110111111001100110111011111111111110111111111110110111011111110111111111010101
11110111101111111011111111a111111110101111a111111001111111111111111111111111111110110011111111111011101110110110111110111101101111110111111111110011111110111111
01011110101100011110110100a111111011011011a011011111110111111111101110111101100111111101011001111110110111000111011101111101011111101011101111111011111101101011
11111011111111111111001111a011111111101111a111110101111111001001110101111011111111111100011101001111111101011110101111111111011011011111101110111101111111011111
11110111111110111011000101a100110111101110a101111010110111111111111111110011111001010111100111100111111111000111111011110101110111111111111101111100010110011101
01111110111110010101111111a111110011011111a011101111111111111100111111001000111111011110100011101111111010011111111111110111111111111101110110111111101111111110
11011011111011111011111000a110001110101101a001111111110111111011001111111111101111111111101100011111111111111101111011110110111111111111111111111111111011110111
10111111011110111001111110a111011101111011a110111111110111110100100111111110111110101110111111011111111011110111001101111100101111111001111111101011011111111111
11111101101111111110110111a011001111111111a111111110111110101111011011111011111010111111110011011111111111110111100111111111111111111111111111110111011011001111
11110111111111111110111111a111001111011111a101111111110110110110111101110111111111111111110110100111111111011111101101111111100111101110111111111111111101110011
11101110110111001110111111a111111111011101a011111110111111111101011111011111011111110110011111111100010111101101010011111111011101111011110010110111111111001111
01111111011111111011111111a111111111101111a111101110111101000111111111111101111011111111101101100111011110111101101111111110101111011110111011101111110111001101
11111111011111110111011111a111101111111010a111111111111111110011011110111111011011111001111111001111101110111001111110001111011011111000111111010111110111111010
00111111011111001100100111a011111111111111a010011111111111111001110111001011011111111110111111110100111110110111110111011111101111110001101011011101111010111101
11111111101111111110110111a101111101110111a111111111101011111111100001111101111110010111111110111110011111101101111001111011010101011111011111111111111001101001
01110010111111111001110111a111111111011111a110222121210222020211121012120101011111101111111111111111111111111100111101111111110101111111010101111111101111111101
10111111111111111111111111a101010111111111a100112020011222021121011122110011011110111011101101101110011111111110011111011101111001220001211022220200212221221012
11111111001111111010111111a101100111011111a102101221222120222122102012221201111110111101111101011110111111111111111111111111011011101112221212122021120201112122
00111111110011110111111111a110111011111101a102110222211222002210211201120011111111110111111111111000110101100001111110111101111111121211202000012122122011120220
01111101001111111011111110a101111111001110a112112221122012121212121122101121101101111011101110111101111111101101111111111111111111120221220100021100110201022202
01111110001100011011111110a111111111111111a110001111020121012122100220221111111110010101111011001111011101011111101011001111111011010211110211222211100202111222
11100111111011011001110110a111111111111111a101122201121110210022122022112211111101011110100110111101110101100111110011111111011011121212221022121221011100212110
01101011001111111111111011a110101111111011a011212112212221221002002110010211111011111001111011011111101111111111111111110111110111210202101222021101121222221212
00111111100111111100111111a111111110111111a010011211122111220202022021011200111111111111011010111111011111111111111111111010111111002022121001201222222012122211
10111011010011110011111011a111111111111011a110221022221111121111221010101211011111001011111110111110111111111111111111110111111111002101112101110222212022220212
10111110111111100111001101a011011111111111a112211222220121022012011222111021011111011111111110101010101111111111110111101101110111222221211102011122011222122221
11111011111001110110100111a111101111111110a100020000201021122111212202222121011111100011110100011101111111111110111111110011110111011021121210011212222210102111
10111101111110111111111111a111101111111011a111202121211122002210220201212221011111111110110011100111101011111111010111111001101111010212122101110102112212112220
11111111000101011011111111a110111010111111a111211121201201010122010210111001111010111101111101110111111110111111111110110111110110010221201210122222022210122111
01111111101111101111011111a111111110110110a112001212011212111202112012120200111001111101110110111101111111110111101011011111110101021121211020000000110220002221
01101111101011101001111110a101011111101111a111221102220211202121012212222210110111110101111110111001010011011111101100111100101111021102201222222121112022121021
11011111110011111111011100a111111101111111a001210112020012101112110121011011111101011011111111111111111110110111110111111110111110111112021122220221121211110222
00011011001011111101111110a111001111111111a111110120222111202111122200111221111001111011111110101111110111110111111001001111110110021110011110102221211212201022
10011111011110010111111011a110111100111101a110221021221112210220211121120201111111011011010110001111111111010101111111111111011111212220102211120011102201110222
01111011111111010111111110a110111111110100a100010121022020120120000201120121111111111110011111111101101110011111011111010101110111010201111111101202022112112102
