(6, 9)
(141, 114)
(149, 67)
(86, 53)
(133, 68)
(2, 47)
(97, 109)
(92, 90)
(52, 89)
(155, 58)
111111101011111011011111111110111011111110011111111111110111001111110001111011111a101111111a11011011100111110111101110111111110010110111001011111110111011110110
110110101010111111110111111110101111111111111011011101111111110001111110111111111a001110111a11011111011001011111110111110111111111011111011011011111111111111010
011111011001010111111111111101110101111111011111011001011101110111111111101011011a011111000a11110101101111101111111101101111111111111001111101111111111111110111
111111111011110011011011110111001110110110011111111111111001111111011111111111111a111111101a11111111100111111011100011111110111111011011011111101111111111110101
111111111010101111111111011110011111101101010111111111111111111110101101111011111a111110101a11110000111111000011111101101101111101011001111011111111011111111111
101101110111110101111001111111111111111111110011111111111111111111111001100111101a101111111a11010100101111101011100011101111111111110111101011101110111111101111
111110011101101111100111111101011011111000111111010110111111111111110110111011110a111110110a11111111011101110111111111010011011111111111111111101111111010110110
111111111001011111111111101101110111110010111111101111111111111111111100110100111a111111111a11110111111001111011010110011001111111110110111111011111111111110011
111111001110001111010111011101111110111111011011011100011111111111111010101110110a111111110a10111111111111111111011110111000100111111111111011111101111011111101
011011101101011110111010111010110111110111111111111111111111101111111111101111101a111110110a00111111110111111111111111101111101111101000011111111100111101111111
011111111110110111111111111001011111111111101111111011011011111011011101111011100a011111111a11111111101101001111111101111110111011010011011101001101111111010111
101111110110100101111011111110011101111111110111011111011101110111101101111110111a011110100a11111010110010111011111111111111111011111111111111110111111111111111
011011111110111111111101111111101110110011100011011111001110110101111011111111110a111011111a01111110100010111011101111111110111110111111101100111111001111110111
101111011111010111111101101101111111111001110111010111111001101111111101001011111a111101111a10111111101110101111111010001111111111111101111111111101111101001101
011111111011010110101111100101111111011111111111111101111111111111111010111111110a111011101a11101101111101111110000101100110111101111111010111111111101011101111
011011001111111101011111111111100111011111111101011110110111011101111110111110101a111111110a11111111101111111111010101111101111110101111111001001011011111101110
110001100110111110111111111111101111101110100100101011010111111111010110111011101a010111011a10111100111111101110011011001101111111111010011011011111011111111111
011101111111101011101010110111111101010111111111111111110101111111111110111111010a111100111a10111111110111111001111111110101111111011111011010111100111111011011
110111111101101111111101110111101011111111101101101110111111011111110101111111011a011111111a10111111111101111111111111111111111011111100111111111011111111011111
111101111111101011101001110111101011011110110111111111101111011110111010011101100a011111110a10111111111110010101111110111111110101111010110111111101011011111111
aaaaaaaaaaaaaaaaaaaaaaaaaaaaaaaaaaaaaaaaaaaaaaaaaaaaaaaaaaaaaaaaaaaaaaaaaaaaaaaaaa101111101a10111110111110111110111101111101001111111000111111111111101110111011
1100011100111111100111111111111111100110110101111011111111111110111111111111011101111011111a10011111111011100111111111001011010111110111110111101100111110010110
1110111111011111100111110111111111011111011111111111111111011110111111111010111110111111011a10011101111101101111111111011111111111100011101111111111111111111111
1111111111010110101011101101011111111111111111011111011111101111101111101111111011011101111a01110111011110111110101011011111111111111111111011110111111111100011
1011111111111011011110111010111111110111011111001111011001101111111111011111101111111110011a01111111011111111111111110110111110011010111101100101111111110101111
1011101011111111011101011011111111100101101011110111111111111101111110111101101011111011011a01000011111001111101011011110111110101111111111111011111110111111111
1011111011110110101101111110101011001111111100111011110011110111111010111011100111011101111a10101011110011111111110011111111101101011011110111111100110111010101
1101111111111001111111110111011101111011001110111111111111111111110011101111111101000111101a11111101110110100101111100111101111111101111010111111110011111111111
1111111111111111111011111001110111010101111101111110111011111111111110011111111001111111111a11111111001100111111111111111111111111011111111101010111111111011101
1110110001001011111110101101010111110011110110111110111111011111111110010111111111011111111a11101111110101111111111111100111100111001010111110011101111111111110
0100111011111111111101110111100111011111011111111011111100101110111111001110101111110101111a11101101110101011100101110111111101010111001001111111111110101011001
1111111111101111111111101111011100110011111111111011101111111011111111011111100111101111111a11111111111011111111100111111111111111111110011110011010111110111111
0221101111210021201111111111110011110111111101111110111111010111011111111111111111111011000a11111111111101111111110111111011110111111101111101111011111111000111
1112102111122022211011011111111111110100111100111101111110011111101111011111110100111111111a11111110111101011111110101111111111111111010111110110111111111111111
0212122212122121211001011101010111101111111110111111111111011110111111111001001010111111101a11010110111111111001110111011111101011000111111111101111111101111111
0212202211212101211111110100110111011111011111100011011101101100111111111001011010110101111a01001111100101010011111010110111101110110011110111001111111111101000
2122121222101110011101111111110111110111001111011111011111111101110111111011111111111100111a11010101101101101010011111111111001110111111000111111011011111111111
1012010110001100211111011111011011111110111111101100110101011101100111111011111100111111101a11111011110101101111010111110011111111111111110111111111110111110110
0011110021111200210111110101111101010111111110111111111011010111010100001221110120111210201a12221021111111111100111111111011111110011110110100110111111011101111
0202201211121202011111011101111111110111011111011101011111110110010111122201120222021111120b22021112211101101111011001110111110111010110111010111111011111111111
2012222112121022111101101111111111111111111110111111111111111011111011111102220112212221001b21111011100011111111110011111111111101101111111101111111010101111111
1221210021212211211111111111110111001011111101110111111110111011110111121111002120001111000a10201002101101111111011101100111110111111110001111101111111111111111
1101120100111121111111011111111011111111111110110011001111111111111101112200110111112121022a12012212211011111110110101110110111111111011111111101011011101101000
1101101002212222111110101111111111111111010100011001111110010101101011101012210101110012122b20122100211111111111111001011111111110111011111112001012012020101201
0112112210122022211101111100011110111110101011110011001101100010110101110112201200110102011b20021222001111011111111101101111001111111000111112220021202122020122
0201212221221112201111011111111000111101111110101011001111101111011011100221001122111101021a21100220111101111111111101010100110011111010101102110212201220112212
0001112221111211110111111111011111111111111110111010111101010111111110012112111021021221011a02002221111111101111100001101001011101011111111102121022112200222221
1102201021212020111111111111110111111101010001011001111110110111011101122201101121210112102a21111111011111001010111111011111101110101111011102011121211122101122
1121012102111121111110111111111111111111110110100111001111111100001111111111010102221202212b20220121010111111111111111011111111111111111111101210000200021112221
1220112121012211111010111111111100011111101100100111101111111110111111021012200210022211202b11220121111010101111101111111011111111111111111012222112220222112001
1221210212211111111111101111010011111110101111111111111011111011111111112100100201110121111a12021221210111110110001111011111011100011111111110112100221111221221
1212211201120201011111011110110110101101110111000101110111111100111111122010121121012122202b21121211211010111101010111011011111011110110111112222112202112212201
2011101012202112001111111111111111111111000111101110011110110110001101121122221101222112011a12121201011111111111111001110010011011111121210221220220022220002222
1222112020002222210111111101111110011110110111111111111011111010111010121111211211121121111b02012220211110111101111101220221021212101110102120022222220202212021
0212210020012212210111101101011110100111111111111101111100011011111111122220010001101221222a12211201111111111111111101221212111021112122222220222222110022202212
2221011211012120211111111111111111111111101111110111111111111110111111101220221210120202110b00121220211111111101111111110222202221220112120222222202220222200020
2210121112012122211100001111111101111010110101011011111111001111111010111112001220112221212b20122001111110111101111001012200211222121212122220220220022221020222
2221211122122111211011001111111111100111100111111111111100110111011110000212011121102211101a12222101111111111110011101021110112111212002210101022202122012102122
1222111022002211211111011001111111111111001111011110111111101111111111021101210121220001100a00120220001111110101111111212100201112122120222020222222222212212222
1202210001221120211101111111110111111011101111011111111111111111111111121100222120122021021a21101121101111111101011111001102020221102012221222122222212210102022
0121020020012212210101111110111111101111111011111111111111111110111111002222101221102122221b12111101211111111111111100011211102101112102022122222202222222012010
2012212021101200111001111011111100111111110111111111111001111011111110010201102110222112222a21001122211111110011110111011201122020011122221222010222121120200201
1111011111011100111110110011101111100111110111111111010111111001111100111021111222212220021b20012021211110111110111111101001111020221102022220202122112220222020
1001110111111101110111011101111011111001111110110110011111111101111001121212101111222002120a00022212111111111001111111010221222021021202202202122212222120022022
0111011101111111111101111111111111011101111011111011111111111111100101112212220201121021220b21211221211110111110111111121212002122222102102222200222122000220222
0101001111111101110110101111111111111010001100110001111110100111111100122211012012110111221b12022221110111111001111011111011221122111220011202202122122222221122
0011010101111110111111111111111111111111111110111110101101111010011101110122100201202222121b10010110011111111110111111221220101121221022220222002122212202021122
1101111110101011111101111110111111111111011101111101011111111111111111122011111111122101022a11220101211110111110101101101210022211210202112202221220220021022212
1111110110011111111111101111111111111111111111111001010111000101110110111111101011111011111a11110111101111111111111001212202111210001202221020122222121202220222
1101110111111111111111101110011111111011101110011111110110111110111111101001111011110111110a11111111101100010111101101210211201111221122222022222022112022011222
1101111010110111110111110101111111111111111111110111011011100111100101111101010111010011111a10111111001011110111111011020221201211112102221222222222022020022222
1001111111111101101111101111111110110010110001011111100010111111011111111100110111011111111a11111110111111011111011111120201112022110222210202222202022200112122
1110111100111101111101111011111100101111111110101111111010110100101111101111110111110111111a11110110111011111110111111002111122012022222221200222022212201202222
1101111110010111011110110110111111111101011111011011111111111111001110011111111111011011111a11111111011111111111011101221011002112101112221020022222121222022211
1111111111001111101111111111111111111201022012111112101001000112211110111101111011111011111a11110010111101110111100011021221110002001022212022010202122111101221
1111111111111111110111101011111111111112000011112111211111211101211111111011110001021210012b21221122102221210111111010221201021001112101210220100221011202121122
1101110110111101101101101101011011111122211212222121021211202202121111111110121101100221110a20202002202001111100110111112120110221111222021222212011122120120120
1011110111111110001101110001101010100022121202012222122220221102202111111111022022221101001b11101210212022011111111001121112120211220122022212222222222220121012
1111111111101111111010111110111111011020102222202002211200201112021111111111000222120110202b10221100221100010011111011111010200212202112121112202022001220002220
1111001111111011111101100111110111101122111022101110100211202211111011111110122011222220220b20211221110012011011101000222221111022211221222121220222011222022121
aaaaaaaaaaaaaaaaaaaaaaaaaaaaaaaaaaaaaaabaabbbbaabbbbbabbabbbbabbbaaaaaaaaaaaaabbbaaabababbab21101100210011111111111111222222220121112022201212120202212202211111
1011110111110111101111010011010101111211011212102212120001122201201100111110122211112011120112111122112220011111110111022122021000121012211202211211202000111221
1011010110111111111111111111111111111020222121211000121212021111221111111011111111202122102112121221021211100111111101211022101221012212202111002101101110111011
1111111111110011011111101110100110111101101111121101212222002022121111101111021002221221010101222212222202011100011111110111111111111111111101010111011111101110
1011111010111110101111011110111101110121210110112111202012111110012110010111120101211212121110021110201112111111110001010110111111111011110110111101111111101111
1111111111111101111011111111111101111021011222012222222221121110020110110111111100212112112101210101201122010111110111001111111111111111101110111011111110110101
0111111110111111010111111001100110100020102001011120111222102121120111101011101220022222221212101220120111211011111110100011101100100111110101011111111101010111
1111101111110101111111111111111010111021012221102222221222202112002111111110022220111221212021121212222022111010011101111011101101111101101101110101011110111111
1110110111111110110111101011111101101122111120202111211111212221212111010111102120121201112110220021011110010011001111101111110110111011111111111110010011111011
0111001011100111111111111111111110011102220111101112101210121222210111111111011211120011221210111120200011111111011111011111111011011101111101011101111110110111
1010000111111111111101110101111111101111200212201002222220101121101111010101011100210221021200221220001011210111111101111111110101111011110111111111111011010111
1110110111111111101011111111011110110201122101011211111220102102212111001111021012211000122112111121121110010011100001111011101011110111111110111011111111101111
1111111111011111110111111101111001010201101121111201102211002220012111111011112220111021200111012121020011001110101011111111111101100000101100111110111111101111
1111000111111111111011111110101101111111112211101120011212000011112111011111022221111220211121020111121110111101111111100111111011001111101101111110011111110011
1111011110011101101110111100111110110111010212211220001210122122112011111111121101120200121222202200202212001111011011111111111111111111100111101111101111111001
1111111111111000101011111111111111101110022022211110111221221220112111101111112220121201220122211012221222011212101011110101110110001111111101111110111101101111
1101110100111110111111100011111111110011111202111111111121122221220111111111002121200222222222001212020121221012110111111011111001011111111001111111110110100111
1011110100010111111110111111111011111211212222112102201022212220121111111111122001120112212222102210102101212122011011111001011010101111011110011111111111011111
aaaaaaaaaaaaaaaaaaaaaaaaaaaaaaaaaaaaabbaaaaabababbabbaaaaababbababaaaaaaaaaaabbbabbbabbbbbbabbbababbbababbbabbbaaaaaaaaaaaaaaaaaaaaaaaaaaaaaaaaaaaaaaaaaaaaaaaaa
1011111011011111111111011111111011111011001020212020212111100222221011111101020100020122002202022122222122022101111100011110110111111111101110111110111011010111
1111111110111111110111111011111011111111212220112211122121111211120010111100122211021212222022222122220222211122011110111001101111111101111101110111111100111000
1111111110111111101111111111111111110120022012020112222101222022220101111111121122222222001222122210112022202221111100111100111111011111111111111111110111111011
0011100110111101101110110111111111111212102010110211212221121220102111101111111222222120200222221002222210210122111111111111110111111111110011011111001111111011
1111100110110111111001111111111111111210111112221111101111121212222001001111120112221222212122022210122112210211100110111101111111010100111111111110011111110011
1110101011001010111011101111111111110111001111110011111101011101110100111011010110022122221222021100202022212111011111010111111011011111111110111110101111111110
0011111111010010011111111011111111111110111101111011111100111111111111101111101110202201120222210102120222121111111111101111111111101110111011011111111111111101
0111011111011111101011110111111111111101011101110111011111111011011111101011111101022112200122202022111111212022111101011111111110011111111111111100101101111101
1111011110011101111111111111111010011011111111110111111111111011101111011110111111122220211012220212200101102210111101010111111111101111011111011011111001011101
1101010111110110101110000111111111111111111010111111110001111011110111110111110101221011121200202011212112102120011111010101111111101101110111110111101111111101
1111110111101011111110111010110111111011110101011111111111110101010111111101111111022122221001221011212222211122110111101111111111011111111011101111011111111101
0111110110011111001101101111111110011010001110111111111010111110111111110011011110022021102012201211211121211111011111111111110011011101111111111100111111111111
1111101010111101011111110110111011101111011111011111111111111111010111110101111110121202022001222211111110222022111111101110011111111111101010011110110011101011
1111111111110110111001111111111110010111110111011111111011110111111110111001101111102210111211002120212200212112111110011110111101110111111111001110111101011010
1001110101011111111101110011101111011010111011111111011111101111111110111111111111120000121022111211022122221122111111001011111111011101111101111011111111110110
0111111111110101110011011111100110100111110110111101110011001111111110111111111111212222120010211120222211021211111101110111111111101001100101111111111111111111
1101111011100100111aaaaaaaaaaaaaaaaaaaaaaaaaaaaaaaaaaaaaaaaaaaaaaaaaaaaaaaaaaaaaaabaabbbbaabbababababbbabaababbaaaaaaaaaaaaaaaaaaaaaaaaaaaaaaaaaaaaaaaaaaaaaaaaa
0100111111111111111a11111111110110111111110111111111110011111110111111111100110111111201102122021122101112101122111010111111101111111111111101110111111101011111
1111010111100101001a11111011111111111111110110111111111011011011110100100111110111120021122112110021222222121110001111111101111111111011110111100111110101111111
1110101111101111100a11111101011111111110111111111011001111111110111111111101111101210211100212011101111221010212011001111101111101111001101111111111011011111011
1011111001111101011a10110111111011110111101101111111111110111111110101111111000111222010111212221111011112211111011011111111111001111110011111111111111111111101
